Deutsch
Information:=Informationen:
Progress:=Fortschritt:
Options=Optionen
source folder=Quellordner
destination folder=Zielordner
overwrite file, if newer=Datei überschreiben, wenn neuer
copy everything=Alles kopieren
delete old files=Alte Dateien löschen
start backup=Backup starten
Notification:=Meldungen:
elapsed time:=Vergangene Zeit:
current file:=Momentane Datei:
amount of files:=Anzahl Dateien:
file=Datei
remaining time:=Verbleibende Zeit:
If you'd start, I could calculate it ;)=Wenn du anfangen würdest, könnte ich es dir berechnen ;)
language=Sprache / language
If a file exists in the backup folder, \nbut not in the original folder, \nit'll be deleted.=Wenn Daten im vorhandenen Backup existieren, \ndie im aktuellen Datenstand nicht vorhanden sind, \nwerden diese alten Dateien gelöscht.
stop backup=Backup stoppen
The backup is still running!\nExit anyway?=Das Backup läuft noch!\nWirklich beenden?
exit=Beenden
detecting files ...=Ermittle Dateien ...
ERROR:=FEHLER
finished=Fertig
not precise ( is subject to the law of large numbers )=Nicht präzise ( unterliegt dem Gesetz der großen Zahlen )
save=Speichern
delete=Löschen
copy files ...=Kopiere Dateien ...
delete old files ...=Lösche alte Dateien ...
skipping files ...=Dateien werden übersprungen ...
shutdown after finish=Nach beenden herunterfahren
detecting old files ...=Ermittle alte Dateien ...
files has been detected=Dateien wurden ermittelt
backup successfully finished=Backup erfolgreich fertig gestellt
report error=Fehler melden
copy=Kopieren
no file exists=Keine Dateien vorhanden
Please report the error and send the content of the following file:\n=Bitte melde den Fehler und sende dabei den Inhalt aus folgender Datei:\n
The backup is still running!\nAbord anyway??=Das Backup läuft noch!\nWirklich abbrechen?
duration:=Dauer: 
backup aborded=Backup abgebrochen
about SimpleBackup=Über SimpleBackup
open=Öffnen
settings=Einstellungen
help=Hilfe
to the Sourceforge projekt=Zum Sourceforge Projekt
search for updates=Nach Updates suchen
write review=Bewertung schreiben
pause backup=Backup pausieren
resume backup=Backup fortsetzen
ERROR: The path=FEHLER: Der Pfad von
is to long.=ist zu lang.
new=Neu
About SimpleBackup=Über SimpleBackup
SimpleBackup is a open source backup tool.\nIt's intended to create quickly and easily a backup\nin which unnecessary paraphernalia is left off.";//"SimpleBackup ist ein Open-Source Backup Tool.\nEs soll dazu dienen einfach und schnell simple\nBackup zu erstellen, wobei auf \nomplizierten \nund teils unnötigen \"Schnick Schnack\" \nverzichtet wird.=SimpleBackup ist ein Open-Source Backup Tool.\nEs soll dazu dienen einfach und schnell simpel\nBackup zu erstellen, wobei auf \nkomplizierten \nund teils unnötigen \"Schnick Schnack\" \nverzichtet wird.
check for updates=Auf Updates prüfen
back=Zurück
by Hauke L. Stieler=von Hauke L. Stieler
general settings=Allgemeine Einstellungen
saved settings=Gespeicherte Einstellungen
choose Languageuage=Sprache Auswählen
reset all=Alles zurücksetzen
save=Speichern
cancel=Abbrechen
list of all saved settings=Liste aller gespeicherten Einstellungen
ok=OK
delete=Löschen
creates a new entry with the entered paths and current settings.=Erstellt einen neuen Eintrag mit den eingegebenen Pfaden und momentanen Einstellungen.
copies the settings file ( some.settings ).\nSave previousley to copy current settings.=Kopiert die Einstellungsdatei ( some.settings ).\nSpeichern sie vorher um momentane Einstellungen zu kopieren.
settings=Einstellungen
create backup of settings=Backup der Einstellungen erstellen
downloading file ...=Datei wird heruntergeladen ...
current version: =Aktuelle Version: 
latest version: =Neuste Version: 
update avalaible=Update verfügbar
no update avalaible=Kein Update verfügbar
download update=Update herunterladen
back=Zurück
SimpleBackup update=SimpleBackup Aktualisierung
Program runs in background=Programm läuft im Hintergrund
Program back on top=Programm im Vordergrund
Exit=Beenden
Info=Info
click here to report error=Hier clicken um Fehler zu melden